{
  "id": 6,
  "words": ["SATU", "RUSA", "URAT", "RATU", "SURAT"],
  "random_letters": ["S", "A", "T", "U", "R"],
  "grid": [
    ["1","1","1","1","1","1","1","1","1","1","1","1","1","1","1","1","1","1","1","1","1","1","1","1","1"],
    ["1","1","1","1","1","1","1","1","1","1","1","1","1","1","1","1","1","1","1","1","1","1","1","1","1"],
    ["1","1","1","1","1","1","1","1","1","1","1","1","1","1","1","1","1","1","1","1","1","1","1","1","1"],
    ["1","1","1","1","1","1","1","1","1","1","1","1","1","1","1","1","1","1","1","1","1","1","1","1","1"],
    ["1","1","1","1","1","1","1","1","1","R","1","1","1","1","1","1","1","1","1","1","1","1","1","1","1"],
    ["1","1","1","1","1","1","1","1","1","A","1","1","1","1","1","1","1","1","1","1","1","1","1","1","1"],
    ["1","1","1","1","1","1","1","1","1","T","1","1","1","1","1","1","1","1","1","1","1","1","1","1","1"],
    ["1","1","1","1","1","1","1","1","1","U","R","A","T","1","1","1","1","1","1","1","1","1","1","1","1"],
    ["1","1","1","1","1","1","1","1","1","1","U","1","1","S","1","1","1","1","1","1","1","1","1","1","1"],
    ["1","1","1","1","1","1","1","1","1","1","S","A","T","U","1","1","1","1","1","1","1","1","1","1","1"],
    ["1","1","1","1","1","1","1","1","1","1","A","1","1","R","1","1","1","1","1","1","1","1","1","1","1"],
    ["1","1","1","1","1","1","1","1","1","1","1","1","1","A","1","1","1","1","1","1","1","1","1","1","1"],
    ["1","1","1","1","1","1","1","1","1","1","1","1","1","T","1","1","1","1","1","1","1","1","1","1","1"],
    ["1","1","1","1","1","1","1","1","1","1","1","1","1","1","1","1","1","1","1","1","1","1","1","1","1"],
    ["1","1","1","1","1","1","1","1","1","1","1","1","1","1","1","1","1","1","1","1","1","1","1","1","1"],
    ["1","1","1","1","1","1","1","1","1","1","1","1","1","1","1","1","1","1","1","1","1","1","1","1","1"],
    ["1","1","1","1","1","1","1","1","1","1","1","1","1","1","1","1","1","1","1","1","1","1","1","1","1"],
    ["1","1","1","1","1","1","1","1","1","1","1","1","1","1","1","1","1","1","1","1","1","1","1","1","1"],
    ["1","1","1","1","1","1","1","1","1","1","1","1","1","1","1","1","1","1","1","1","1","1","1","1","1"],
    ["1","1","1","1","1","1","1","1","1","1","1","1","1","1","1","1","1","1","1","1","1","1","1","1","1"],
    ["1","1","1","1","1","1","1","1","1","1","1","1","1","1","1","1","1","1","1","1","1","1","1","1","1"],
    ["1","1","1","1","1","1","1","1","1","1","1","1","1","1","1","1","1","1","1","1","1","1","1","1","1"],
    ["1","1","1","1","1","1","1","1","1","1","1","1","1","1","1","1","1","1","1","1","1","1","1","1","1"],
    ["1","1","1","1","1","1","1","1","1","1","1","1","1","1","1","1","1","1","1","1","1","1","1","1","1"],
    ["1","1","1","1","1","1","1","1","1","1","1","1","1","1","1","1","1","1","1","1","1","1","1","1","1"],
    ["1","1","1","1","1","1","1","1","1","1","1","1","1","1","1","1","1","1","1","1","1","1","1","1","1"],
    ["1","1","1","1","1","1","1","1","1","1","1","1","1","1","1","1","1","1","1","1","1","1","1","1","1"],
    ["1","1","1","1","1","1","1","1","1","1","1","1","1","1","1","1","1","1","1","1","1","1","1","1","1"],
    ["1","1","1","1","1","1","1","1","1","1","1","1","1","1","1","1","1","1","1","1","1","1","1","1","1"]
  ]
}