{
    "id": 46,
    "words": ["LIBURAN", "LIBUR", "BINAR", "LUNAR", "BARU", "LARI"],
    "random_letters": ["L","I","B","U","R","A","N"],
    "grid": [
      ["1","1","1","1","1","1","1","1","1","1","1","1","1","1","1","1","1","1","1","1","1","1","1","1","1"],
      ["1","1","1","1","1","1","1","1","1","1","1","1","1","1","1","1","1","1","1","1","1","1","1","1","1"],
      ["1","1","1","1","1","1","1","1","1","1","1","1","1","1","1","1","1","1","1","1","1","1","1","1","1"],
      ["1","1","1","1","1","1","1","1","1","1","1","1","1","1","1","1","1","1","1","1","1","1","1","1","1"],
      ["1","1","1","1","1","1","1","1","1","1","1","1","1","1","1","1","1","1","1","1","1","1","1","1","1"],
      ["1","1","1","1","1","1","1","1","1","1","1","1","1","1","1","1","1","1","1","1","1","1","1","1","1"],
      ["1","1","1","1","1","1","1","1","1","1","1","1","1","1","1","1","1","1","1","1","1","1","1","1","1"],
      ["1","1","1","1","1","1","1","1","1","1","1","1","1","1","1","1","1","1","1","1","1","1","1","1","1"],
      ["1","1","1","1","1","1","1","1","1","1","1","1","1","1","1","1","1","1","1","1","1","1","1","1","1"],
      ["1","1","1","1","1","1","1","1","1","1","1","L","1","L","1","B","1","1","1","1","1","1","1","1","1"],
      ["1","1","1","1","1","1","1","1","L","1","L","I","B","U","R","A","N","1","1","1","1","1","1","1","1"],
      ["1","1","1","1","1","1","1","1","A","1","1","B","1","N","1","R","1","1","1","1","1","1","1","1","1"],
      ["1","1","1","1","1","1","1","1","R","1","1","U","1","A","1","U","1","1","1","1","1","1","1","1","1"],
      ["1","1","1","1","1","1","1","B","I","N","A","R","1","R","1","1","1","1","1","1","1","1","1","1","1"],
      ["1","1","1","1","1","1","1","1","1","1","1","1","1","1","1","1","1","1","1","1","1","1","1","1","1"],
      ["1","1","1","1","1","1","1","1","1","1","1","1","1","1","1","1","1","1","1","1","1","1","1","1","1"],
      ["1","1","1","1","1","1","1","1","1","1","1","1","1","1","1","1","1","1","1","1","1","1","1","1","1"],
      ["1","1","1","1","1","1","1","1","1","1","1","1","1","1","1","1","1","1","1","1","1","1","1","1","1"],
      ["1","1","1","1","1","1","1","1","1","1","1","1","1","1","1","1","1","1","1","1","1","1","1","1","1"],
      ["1","1","1","1","1","1","1","1","1","1","1","1","1","1","1","1","1","1","1","1","1","1","1","1","1"],
      ["1","1","1","1","1","1","1","1","1","1","1","1","1","1","1","1","1","1","1","1","1","1","1","1","1"],
      ["1","1","1","1","1","1","1","1","1","1","1","1","1","1","1","1","1","1","1","1","1","1","1","1","1"],
      ["1","1","1","1","1","1","1","1","1","1","1","1","1","1","1","1","1","1","1","1","1","1","1","1","1"],
      ["1","1","1","1","1","1","1","1","1","1","1","1","1","1","1","1","1","1","1","1","1","1","1","1","1"]
    ]
  }