{
    "id": 23,
    "words": ["RAHMAT", "RAMAH", "MARAH", "ARAH", "MAHAR"],
    "random_letters": ["R","A","H","M","A","T"],
    "grid": [
      ["1","1","1","1","1","1","1","1","1","1","1","1","1","1","1","1","1","1","1","1","1","1","1","1","1"],
      ["1","1","1","1","1","1","1","1","1","1","1","1","1","1","1","1","1","1","1","1","1","1","1","1","1"],
      ["1","1","1","1","1","1","1","1","1","1","1","1","1","1","1","1","1","1","1","1","1","1","1","1","1"],
      ["1","1","1","1","1","1","1","1","1","1","1","1","1","1","1","1","1","1","1","1","1","1","1","1","1"],
      ["1","1","1","1","1","1","1","1","1","1","1","1","1","1","1","1","1","1","1","1","1","1","1","1","1"],
      ["1","1","1","1","1","1","1","1","1","1","1","1","1","1","1","1","1","1","1","1","1","1","1","1","1"],
      ["1","1","1","1","1","1","1","1","1","1","1","1","1","1","1","1","1","1","1","1","1","1","1","1","1"],
      ["1","1","1","1","1","1","1","1","1","1","1","1","1","1","1","1","1","1","1","1","1","1","1","1","1"],
      ["1","1","1","1","1","1","1","1","R","A","H","M","A","T","1","1","1","1","1","1","1","1","1","1","1"],
      ["1","1","1","1","1","1","1","1","A","1","A","1","1","1","1","1","1","1","1","1","1","1","1","1","1"],
      ["1","1","1","1","1","1","1","1","M","A","R","A","H","1","1","1","1","1","1","1","1","1","1","1","1"],
      ["1","1","1","1","1","M","1","1","A","1","T","1","1","1","1","1","1","1","1","1","1","1","1","1","1"],
      ["1","1","1","1","1","A","R","A","H","1","A","1","1","1","1","1","1","1","1","1","1","1","1","1","1"],
      ["1","1","1","1","1","H","1","1","1","1","1","1","1","1","1","1","1","1","1","1","1","1","1","1","1"],
      ["1","1","1","1","1","A","1","1","1","1","1","1","1","1","1","1","1","1","1","1","1","1","1","1","1"],
      ["1","1","1","1","1","R","1","1","1","1","1","1","1","1","1","1","1","1","1","1","1","1","1","1","1"],
      ["1","1","1","1","1","1","1","1","1","1","1","1","1","1","1","1","1","1","1","1","1","1","1","1","1"],
      ["1","1","1","1","1","1","1","1","1","1","1","1","1","1","1","1","1","1","1","1","1","1","1","1","1"],
      ["1","1","1","1","1","1","1","1","1","1","1","1","1","1","1","1","1","1","1","1","1","1","1","1","1"],
      ["1","1","1","1","1","1","1","1","1","1","1","1","1","1","1","1","1","1","1","1","1","1","1","1","1"],
      ["1","1","1","1","1","1","1","1","1","1","1","1","1","1","1","1","1","1","1","1","1","1","1","1","1"],
      ["1","1","1","1","1","1","1","1","1","1","1","1","1","1","1","1","1","1","1","1","1","1","1","1","1"],
      ["1","1","1","1","1","1","1","1","1","1","1","1","1","1","1","1","1","1","1","1","1","1","1","1","1"],
      ["1","1","1","1","1","1","1","1","1","1","1","1","1","1","1","1","1","1","1","1","1","1","1","1","1"]
    ]
  }
  
